111111111111111111111111111111
1P0000000000000000000000000001
1000000000CCCC000CCCCCCCC00001
100000000CCCC0000CCCCCCCC00001
10000000CCCC00000CC00CCCC00001
1000000CCCC000000C000CCCC00001
100000CCCC000000000CCCC0000001
10000CCCC000000000CCCC00C00001
1000CCCCCCCCCCCC0CCCC00CC00001
1000CCCCCCCCCCCC0CCCCCCCC00001
1000CCCCCCCCCCCC0CCCCCCCC00001
100000000000CCCC00000000000001
100000000000CCCC00000000000001
100000000000CCCC00000000000001
1000000000000000000000000000E1
111111111111111111111111111111
